Station;Travelers_per_day;Getting_on_off;Switchers;Direction_to;Travelers_to
Groningen;16064;16064;0;Groningen Europapark;8000
Groningen;16064;16064;0;Groningen Noord;n/a
Groningen;16064;16064;0;Zuidhorn;n/a
Groningen Europapark;1705;1705;0;Haren;9000
Groningen Europapark;1705;1705;0;Groningen;8000
Groningen Europapark;1705;1705;0;Kropswolde;n/a
Haren;1104;1104;0;Groningen Europapark;8000
Haren;1104;1104;0;Assen;9000
Assen;7548;7440;108;Haren;8000
Assen;7548;7440;108;Beilen;9000
Beilen;1824;1824;0;Assen;8000
Beilen;1824;1824;0;Hoogeveen;9000
Hoogeveen;3782;3782;0;Beilen;8000
Hoogeveen;3782;3782;0;Meppel;9000
Meppel;6386;5768;618;Zwolle;14000
Meppel;6386;5768;618;Hoogeveen;9000
Meppel;6386;5768;618;Steenwijk;5000
Leeuwarden;7705;7705;0;Grou-Jirnsum;4000
Leeuwarden;7705;7705;0;Leeuwarden Camminghaburen;n/a
Leeuwarden;7705;7705;0;Mantgum;n/a
Leeuwarden;7705;7705;0;Deinum;n/a
Grou-Jirnsum;727;727;0;Leeuwarden;4000
Grou-Jirnsum;727;727;0;Akkrum;4000
Akkrum;769;769;0;Grou-Jirnsum;4000
Akkrum;769;769;0;Heerenveen;4000
Heerenveen;5001;4970;31;Akkrum;4000
Heerenveen;5001;4970;31;Wolvega;4000
Wolvega;1394;1394;0;Steenwijk;4000
Wolvega;1394;1394;0;Heerenveen;4000
Steenwijk;3007;2958;49;Meppel;5000
Steenwijk;3007;2958;49;Wolvega;4000
Zwolle;42976;33802;9174;Meppel;14000
Zwolle;42976;33802;9174;Wezep;10000
Zwolle;42976;33802;9174;Kampen Zuid;8000
Zwolle;42976;33802;9174;Wijhe;4000
Zwolle;42976;33802;9174;Heino;n/a
Zwolle;42976;33802;9174;Dalfsen;n/a
Kampen Zuid;1618;1618;0;Zwolle;8000
Kampen Zuid;1618;1618;0;Dronten;8000
Dronten;2931;2931;0;Lelystad Centrum;8000
Dronten;2931;2931;0;Kampen Zuid;8000
Lelystad Centrum;12592;11076;1516;Almere Oostvaarders;11000
Lelystad Centrum;12592;11076;1516;Dronten;8000
Lelystad Centrum;12592;11076;1516;Lelystad Opstel;n/a
Almere Oostvaarders;3478;3478;0;Lelystad Centrum;11000
Almere Oostvaarders;3478;3478;0;Almere Buiten;12000
Almere Buiten;4679;4574;105;Almere Oostvaarders;12000
Almere Buiten;4679;4574;105;Almere Parkwijk;14000
Almere Parkwijk;1834;1834;0;Almere Buiten;14000
Almere Parkwijk;1834;1834;0;Almere Centrum;14000
Almere Centrum;26979;20873;6106;Almere Parkwijk;14000
Almere Centrum;26979;20873;6106;Almere Muziekwijk;21000
Almere Muziekwijk;4217;4215;2;Almere Centrum;21000
Almere Muziekwijk;4217;4215;2;Almere Poort;22000
Almere Poort;5925;5428;497;Almere Muziekwijk;22000
Almere Poort;5925;5428;497;Muiderberg aansluiting;23000
Muiderberg aansluiting;n/a;n/a;n/a;Almere Poort;23000
Muiderberg aansluiting;n/a;n/a;n/a;Weesp;20000
Weesp;13907;8985;4922;Diemen Zuid;21000
Weesp;13907;8985;4922;Diemen;20000
Weesp;13907;8985;4922;Muiderberg aansluiting;20000
Weesp;13907;8985;4922;Naarden-Bussum aansluiting;19000
Naarden-Bussum aansluiting;n/a;n/a;n/a;Weesp;19000
Naarden-Bussum aansluiting;n/a;n/a;n/a;Naarden-Bussum;22000
Naarden-Bussum;8815;8490;325;Naarden-Bussum aansluiting;21000
Naarden-Bussum;8815;8490;325;Bussum Zuid;20000
Bussum Zuid;3684;3684;0;Hilversum Media Park;20000
Bussum Zuid;3684;3684;0;Naarden-Bussum;20000
Hilversum Media Park;3875;3875;0;Hilversum;20000
Hilversum Media Park;3875;3875;0;Bussum Zuid;20000
Hilversum;24941;21521;3420;Hilversum Media Park;20000
Hilversum;24941;21521;3420;Baarn;11000
Hilversum;24941;21521;3420;Hilversum Sportpark;8000
Baarn;4150;3967;183;Hilversum;11000
Baarn;4150;3967;183;Amersfoort Centraal;10000
Baarn;4150;3967;183;Soestdijk;1000
Amersfoort Centraal;43123;33180;9943;Den Dolder;21000
Amersfoort Centraal;43123;33180;9943;Amersfoort Schothorst;14000
Amersfoort Centraal;43123;33180;9943;Baarn;10000
Amersfoort Centraal;43123;33180;9943;Hoevelaken;10000
Amersfoort Centraal;43123;33180;9943;Bokkeduinen;n/a
Amersfoort Schothorst;5221;5008;213;Amersfoort Centraal;14000
Amersfoort Schothorst;5221;5008;213;Amersfoort Vathorst;13000
Amersfoort Vathorst;3305;3234;71;Amersfoort Schothorst;12000
Amersfoort Vathorst;3305;3234;71;Nijkerk;11000
Nijkerk;2881;2881;0;Putten;11000
Nijkerk;2881;2881;0;Amersfoort Vathorst;11000
Putten;1573;1573;0;Nijkerk;11000
Putten;1573;1573;0;Ermelo;11000
Ermelo;2225;2225;0;Putten;10000
Ermelo;2225;2225;0;Harderwijk;10000
Harderwijk;4840;4840;0;Ermelo;10000
Harderwijk;4840;4840;0;Nunspeet;10000
Nunspeet;2255;2255;0;Harderwijk;10000
Nunspeet;2255;2255;0;Harde ‘t;9000
Harde ‘t;1169;1169;0;Wezep;10000
Harde ‘t;1169;1169;0;Nunspeet;9000
Wezep;907;907;0;Zwolle;10000
Wezep;907;907;0;Harde ‘t;9000
Wijhe;967;967;0;Olst;4000
Wijhe;967;967;0;Zwolle;4000
Olst;1097;1097;0;Wijhe;4000
Olst;1097;1097;0;Deventer;4000
Deventer;20355;17302;3053;Twello;9000
Deventer;20355;17302;3053;Deventer Colmschate;7000
Deventer;20355;17302;3053;Zutphen;5000
Deventer;20355;17302;3053;Olst;4000
Deventer Colmschate;1153;1153;0;Deventer;7000
Deventer Colmschate;1153;1153;0;Holten;7000
Holten;1118;1118;0;Rijssen;7000
Holten;1118;1118;0;Deventer Colmschate;7000
Rijssen;2124;2124;0;Wierden;7000
Rijssen;2124;2124;0;Holten;7000
Wierden;986;986;0;Rijssen;7000
Wierden;986;986;0;Almelo;6000
Wierden;986;986;0;Nijverdal;n/a
Almelo;6544;6289;255;Almelo de Riet;6000
Almelo;6544;6289;255;Wierden;6000
Almelo;6544;6289;255;Vriezenveen;n/a
Twello;1154;1154;0;Apeldoorn Osseveld;9000
Twello;1154;1154;0;Deventer;9000
Apeldoorn Osseveld;1104;1104;0;Apeldoorn;9000
Apeldoorn Osseveld;1104;1104;0;Twello;9000
Apeldoorn;12590;11628;962;Hoevelaken;10000
Apeldoorn;12590;11628;962;Apeldoorn Osseveld;9000
Apeldoorn;12590;11628;962;Apeldoorn De Maten;n/a
Hoevelaken;n/a;n/a;n/a;Apeldoorn;n/a
Hoevelaken;n/a;n/a;n/a;Barneveld Noord;n/a
Hoevelaken;n/a;n/a;n/a;Amersfoort Centraal;n/a
Den Dolder;1740;1732;8;Bilthoven;23000
Den Dolder;1740;1732;8;Amersfoort Centraal;22000
Den Dolder;1740;1732;8;Soest Zuid;2000
Soest Zuid;1694;1694;0;Den Dolder;1000
Soest Zuid;1694;1694;0;Soest;1000
Soest;212;212;0;Soest Zuid;1000
Soest;212;212;0;Soestdijk;1000
Soestdijk;670;670;0;Soest;1000
Soestdijk;670;670;0;Baarn;1000
Bilthoven;4127;4127;0;Den Dolder;24000
Bilthoven;4127;4127;0;Utrecht Overvecht;24000
Utrecht Overvecht;7306;7145;161;Utrecht Centraal;33000
Utrecht Overvecht;7306;7145;161;Bilthoven;25000
Utrecht Overvecht;7306;7145;161;Hollandsche Rading;8000
Hollandsche Rading;907;907;0;Utrecht Overvecht;9000
Hollandsche Rading;907;907;0;Hilversum Sportpark;8000
Hilversum Sportpark;5797;5794;3;Hollandsche Rading;8000
Hilversum Sportpark;5797;5794;3;Hilversum;8000
Utrecht Centraal;229788;175179;54609;Utrecht Vaartsche Rijn;58000
Utrecht Centraal;229788;175179;54609;Utrecht Zuilen;50000
Utrecht Centraal;229788;175179;54609;Utrecht Leidsche Rijn;39000
Utrecht Centraal;229788;175179;54609;Utrecht Overvecht;34000
Utrecht Zuilen;2431;2431;0;Utrecht Centraal;51000
Utrecht Zuilen;2431;2431;0;Maarssen;50000
Maarssen;3926;3926;0;Utrecht Zuilen;51000
Maarssen;3926;3926;0;Breukelen;49000
Breukelen;5828;5317;511;Abcoude;52000
Breukelen;5828;5317;511;Maarssen;50000
Breukelen;5828;5317;511;Woerden;4000
Abcoude;1899;1899;0;Amsterdam Holendrecht;52000
Abcoude;1899;1899;0;Breukelen;53000
Amsterdam Holendrecht;4177;4177;0;Amsterdam Bijlmer ArenA;53000
Amsterdam Holendrecht;4177;4177;0;Abcoude;54000
Amsterdam Bijlmer ArenA;25873;23751;2122;Amsterdam Holendrecht;54000
Amsterdam Bijlmer ArenA;25873;23751;2122;Duivendrecht;34000
Amsterdam Bijlmer ArenA;25873;23751;2122;Duivendrecht aansluiting west;17000
Duivendrecht;9459;7604;1855;Amsterdam Amstel;34000
Duivendrecht;9459;7604;1855;Amsterdam Bijlmer ArenA;36000
Duivendrecht;9459;7604;1855;Diemen Zuid;21000
Duivendrecht;9459;7604;1855;Duivendrecht aansluiting west;20000
Diemen Zuid;2965;2965;0;Duivendrecht;22000
Diemen Zuid;2965;2965;0;Weesp;21000
Duivendrecht aansluiting west;n/a;n/a;n/a;Duivendrecht;19000
Duivendrecht aansluiting west;n/a;n/a;n/a;Amsterdam Bijlmer ArenA;17000
Duivendrecht aansluiting west;n/a;n/a;n/a;Amsterdam RAI;37000
Amsterdam RAI;4103;4103;0;Duivendrecht aansluiting west;37000
Amsterdam RAI;4103;4103;0;Amsterdam Zuid;38000
Amsterdam Zuid;63365;59214;4151;Amsterdam RAI;37000
Amsterdam Zuid;63365;59214;4151;Amsterdam Riekerpolder;32000
Amsterdam Riekerpolder;n/a;n/a;n/a;Amsterdam Lelylaan;29000
Amsterdam Riekerpolder;n/a;n/a;n/a;Amsterdam Zuid;33000
Amsterdam Riekerpolder;n/a;n/a;n/a;Schiphol Airport;60000
Amsterdam Lelylaan;11292;11290;2;Amsterdam Riekerpolder;28000
Amsterdam Lelylaan;11292;11290;2;Amsterdam Sloterdijk;26000
Amsterdam Sloterdijk;57576;48829;8747;Amsterdam Centraal;69000
Amsterdam Sloterdijk;57576;48829;8747;Zaandam;35000
Amsterdam Sloterdijk;57576;48829;8747;Halfweg-Zwanenburg;27000
Amsterdam Sloterdijk;57576;48829;8747;Amsterdam Lelylaan;25000
Amsterdam Centraal;171272;159833;11439;Amsterdam Sloterdijk;68000
Amsterdam Centraal;171272;159833;11439;Amsterdam Muiderpoort;47000
Amsterdam Centraal;171272;159833;11439;Watergraafsmeer;n/a
Amsterdam Centraal;171272;159833;11439;Amsterdam Lijnwerkplaats Zuid;n/a
Amsterdam Muiderpoort;12515;12295;220;Amsterdam Centraal;45000
Amsterdam Muiderpoort;12515;12295;220;Amsterdam Amstel;28000
Amsterdam Muiderpoort;12515;12295;220;Amsterdam Science Park;21000
Amsterdam Amstel;26593;25208;1385;Duivendrecht;36000
Amsterdam Amstel;26593;25208;1385;Amsterdam Muiderpoort;27000
Amsterdam Science Park;4164;4164;0;Amsterdam Muiderpoort;21000
Amsterdam Science Park;4164;4164;0;Diemen;20000
Diemen;2431;2431;0;Amsterdam Science Park;20000
Diemen;2431;2431;0;Weesp;20000
